blutwurst|bờ lút vuột
powerscale|pao ờ sờ kêu
pellegrini|pê lê gờ ri ni
master|mát sờ tơ
beach|bít chờ
martha-ann|ma tha an
oxy|ô xi
king|kinh
indonesia|in đô nê xia a
flick|phờ lích
ferguson|phơ gu sơn
pochettino|pô chét ti nô
eindhoven|en hồ vờ
vegas|vê gát
libya|li bi
alex|a lếch
xiomara|xi ô ma ra
ruiz|rui
amazonia|a ma dôn ni a
maga|ma ga
bild|biu
bambuup|bem bu ắp
vanja|van nha
school|sờ cun
smartphone|sờ mát phôn
dangda|đang da
ilya|i ly a
greenpeace|gờ rin pi sờ
bill|biu
coli|cô li
gravely|gờ rây vơ li
www|đắp liu đắp liu đắp liu
johan|dô han
accreditation|ơ cờ re đít tây sờn
imo|ai em âu
lviv|lơ viu
samuel|sa mu en
hakon|ha con
university|iu ni vơ si ti
vietsoc|việt sóc
avdiika|a vờ đi ca
avdiivka|a vờ đi ca
laliga|la li ga
yonhap|don háp
nec|en i xi
business|bi di nít
pashin|pa xin
nicklas|ních cờ lát
toyama|tô gia ma
yahoo|da hu
salzburg|san dờ bớc
klinsmann|cờ lin sờ man
insider|in sai đờ
sato|sa tô
video|vi đê ô
hardest|hát đít
chicago|chi ca gô
pinehurst|pai hớt sờ
rahman|ra man
aws|ây đắp liu ét
collin|cô lin
ship|síp
paraguay|pa ra goay
blomdahl|bờ lum đa
centcom|xen com
teun|tơn
bundock|băn đoóc
sunsport|săn sờ pót
nazareth|na da rét
stanford|sờ ten phớt
bayer|bay ơ
philipp|phi líp
schmidt|sờ mít
uic|iu ai xi
alvaro|an va rô
frankowski|phờ ran kốp xờ ki
rubymar|ru bi ma
buffett|bắp phét
meloni|mê lô ni
baig|bếch gờ
kluivert|cờ lui vớt
interpol|in tơ pon
teerasil|tê ra xin
garros|ga rốt
premier|pờ rem mơ
andrich|en đờ rích
borrell|bô reo
didier|đi đia
insights|in sai tờ
young|dăng
gpmb|giải phóng mặt bằng
gutersloh|gu tơ sờ lâu
yard|dát
corner|con nờ
wifi|oai phai
rummenigge|ru mơ ni gơ
jr|du ni ờ
coffee|cóp phi
sb|ét bi
newsweek|niu sờ guých
fred|phờ rét
prometheus|pờ rô me thớt
fpt|ép pê tê
nattapan|na ta pan
luhansk|lu han sờ
sdf|ét đi ép
dmitry|đờ mi tri
tazim|ta dim
stuttgart|sờ tút gát
stryi|sờ tờ ri
pool|pun
ukraine|u cờ rai na
giorgia|gióc gia
laporte|la pót
khuzaimi|khu dai mi
globo|gờ lô bô
kamala|ca ma la
nvnonn|người việt nam ở nước ngoài
washington|oa sinh tơn
caf|xê a ép
vstep|vi sờ tép
pokrovsk|pốc cờ râu
yrv|oai a vi
raphinha|ra phi nha
beta|bê ta
sunway|săn guây
buongiorno|buôn giô nô
shanghai|thượng hau
yaroslavskyi|da rô sờ láp sờ ki
budanov|bu đa nốp
jin|din
ednaldo|ét nan đô
ppp|pi pi pi
thierry|thia ri
krah|cờ ra
obligatoria|ô b li ga tô ri a
neuer|noi ơ
carreno|ca rê nô
technology|tếch no lơ di
fauci|phau ci
sarea|sa rê a
alexander|a lếch xan đơ
stream|sờ trim
maps|máp
gas|ga
georgia|gioóc gia
network-quality|nét guốc qua lơ ti
portsmouth|pốt sờ mao
oratmangoen|ô rét men gừn
ahmad|a mát
problem|pờ ro bờ lầm
ludvig|lút vích
west|goét
sergej|sơ gây
wells|goeo
elliot|ê li ốt
houthi|hâu thi
tomas|tô mát
lamine|la min
morning|mo ninh
monaco|mô na cô
vargas|va gát
latinh|la tinh
truss|trút sờ
debate|đi bết
emirates|em mi rết
gcdc|di xi đi xi
angus|ăn gớt
shiung|xi ung
ishii|i xi
rangnick|rác ních
buriram|bu ri ram
patrick|pa trích
kalyan|ka li an
ubkt|ủy ban kiểm tra
cantlay|ken tờ lây
won|uôn
charalambos|ke ra lem bớt
brunei|bờ ru nây
tesco|tét cô
afc|ây ép xi
batshuayi|bát xu a di
rumani|ru ma ni
highlight|hai lai
real|riêu
hamoud|ha mâu
adt|ây đi ti
ronald|rô nan
st|ét ti
brussels|bờ rúc xen
joshua|dô sua
paddock|pa đớc
danos|đa nốt
vksnd|viện kiểm sát nhân dân
bergwijn|bớc uyn
biochar|bai âu cha
balotelli|ba lô te li
inacio|i na xi ô
ryv|a goai vi
calmette|can mét
hemviboon|hem vi bun
michel|mi cheo
sane|sa nê
zeitun|dai tun
collection|cô lếch sờn
kate|kết
syrsky|xia sờ kai i
youtube|diu túp
attal|át tan
ams|am sờ
cargill|ca giu
hovland|hô vờ lan
aden|a đen
allister|a lít tơ
atacms|ây ti ây xi em ét
mahmoud|ma mâu
muirfield|mơ phiu
guitar|ghi ta
usd|iu ét đi
halim|ha lim
martarello|ma ta rê lô
brian|bờ rai ừn
tacchella|ta chê la
instagram|in sờ ta gờ ram
colleges|cô lít di
yo-jong|dô giăng
york|oóc
server|sơ vơ
morikawa|mô ri ca goa
prokopenko|pờ rô cô pen cô
hakan|ha can
mcdonnell|mắc đôn neo
fiorentina|phi ô ren ti na
fifpro|phíp pờ rô
moutinho|mô ti nhô
mbappe|em báp pê
clarke|cờ lác
viettel|việt theo
vatsana|vát sa na
talkshow|thoóc sâu
olympic|ô lim píc
nomiya|nô mi da
kalibr|kha li bờ
shalit|xa lít
siam|xi âm
klopp|cờ lóp
dmz|đi em di
hooligan|hu li gân
fire|phai ờ
amanda|a man đa
wimbledon|guym bờ lơ đơn
widmer|goai mơ
ar|ây a
cacdac|các đác
breton|bờ re tơn
akhyar|ác cờ da
rheinenergie|rai in en nơ gi
schofield|sờ câu phiu
manche|man chê
franco|phờ ran cô
bigdata|bích đa ta
bayonne|ba dôn nê
dawidowicz|đa vi đô vích
khamenei|kha me nây
ngo|en di âu
garang|ga rang
triton|tri tôn
cgpa|xi di pi ây
galaxy|ga la xi
crete|cờ rít
czech|xéc
ivaldi|i van đi
chiesa|ki ê xa
trudeau|tru đê au
szold|sờ dâu
jorginho|gioóc di nhô
manchester|man chét tơ
jadon|da đon
mcclair|mắc cờ le
btc|ban tổ chức
kaka|ka ka
ec|i xi
army|am mi
tass|ti ây ét ét
lugansk|lu gan
carlos|các lốt
spreuerhofstr|sờ pờ re ơ hóp tơ
baba|ba ba
al-qurashi|an qua xi
kroos|cờ rút
league|lích
trailer|trai lơ
moeuy|moe uy
rosetti|rô sét ti
yasen|da sen
antoine|an tôn
wellings|goeo linh
figo|phi gô
snooker|sờ nu cơ
engineer|en di nia
forumspb|pho răm sờ pi bi
amos|a mốt
ltd|eo ti đi
sasalak|sa sa lắc
al-hashimi|an ha xi mi
julian|du li an
brendon|bờ ren đờn
telegram|te le gờ ram
maureen|mau rin
albart|an bát
logistics|lô gít tích
puti|pu ti
airlines|e lai
palmer|pam mờ
thielen|thia len
haraldson|ha ra sơn
montenegro|mông tê nê gờ rô
bxh|bảng xếp hạng
bardella|ba đê la
aquatic|a qua tích
linguaskill|linh gua sờ kiu
mourinho|mô ri nhô
eu|e u
kiryat|ki ri át
iris-t|ai rít ti
rmc|a em xi
dawn|đon
venetian|ve nơ ti ờn
hummels|hum meo
lecornu|lê cô nu
jovic|dô vích
azizi|a di di
mumin|mu min
bunmathan|bun ma than
thongsong|thoong xong
nigel|nai dồ
oleksandr|ô lếch san đơ
dn|doanh nghiệp
kerkez|cơ két
kimmich|kim mích
ko|cây âu
rodryo|rô đờ ri gô
wolf|uốp
peter|pi tơ
marcos|mác cốt
voice|voi
iskander-m|ít kan đơ em
marina|ma ri na
twet|tờ guýt
stojanovic|sờ tô da nô vích
series|xi ri sờ
swiderski|sờ oai đơ sờ ki
polking|pâu kinh
cnn|xi en en
suk-yeol|súc dê on
samba|sam ba
boongke|boong ke
chasiv|cha síp
lexus|lê sớt
equipe|lơ quýp
pasalic|pa sa líc
karl-heinz|kan hét
grimaldo|gờ ri man đô
masia|ma si a
pulga|pun ga
chamorel|cha mô rêu
weerathep|vi ra thép
shalom|xa lom
keane|kin
maksim|mác cờ xim
faisal|phai san
petersburg|pê téc bua
zsu|di ét iu
free|phờ ri
yeisk|éc cờ
shaun|son
simon|si mông
mil|miu
guardian|ga đi ần
nq|nghị quyết
hc|huy chương
wembley|oem bờ li
vietravel|việt tre vờ
schouten|sâu ten
hendrio|hen đờ ri ô
gordon|go đờn
erdogan|éc đô gan
play|pờ lây
al-arouri|an a râu ri
dac|đi ây xi
ylva|iu va
dgx|đi di ách
diff|đi oai ép ép
zakharova|da kha rô va
ulf|iu eo ép
brugge|bờ rút
twz|ti đắp liu di
sefutbol|xe phút bôn
theater|thia tờ
wikman|uých men
bank|banh
nanchang|nan chang
latvia|lát vi a
pccc|phòng cháy chữa cháy
nottingham|nót tinh ham
pomodoro|pô mô đô rô
thethao|thể thao
zalo|da lô
samson|sam sơn
peru|pê ru
mikal|mi kan
zalewski|da lê sờ ki
rostov|rốt sờ tốp
kharkiv|kha kíp
tweet|tờ guýt
christensen|cờ rít ten sen
kuin|ku in
frontiers|phờ răn tia
luka|lu ca
mano|ma nô
ratanakiri|ra ta na ki ri
gorodnichenko|gô rốt ni chen cô
jackson|dách sơn
ricardo|ri các đô
bangkok|bang côc
madrid|ma đờ rít
universiti|iu ni vơ si ti
sxh|sốt xuất huyết
oaks|oác
program|pờ rô gờ rem
sutton|sui tôn
tamaz|ta mát
morosovsk|mô rô sô vờ
uzbekistan|u dơ bê kít tan
alcaraz|an ca rát
sunak|su nác
hitzlsperger|hít dô sờ pơ gơ
vitinha|vi ti nha
burapha|bu ra pha
ousmane|ốt sờ ma nê
colombia|cô lôm bia a
carpet|ca pét
jens|den sờ
herzi|hơ di
given|ghi vừn
rieder|rai đờ
troon|chun
performances|pơ phom mừn
penalty|pê nan ti
donald|đô nan
doha|đô ha
guendogan|gun đô gan
regazzoni|rê ga dô ni
youth|dút
roma|rô ma
krasnoarmeysk|cờ rát nô mây
hydrocarbon|hai đờ rô các bon
palau|pa lau
tphcm|thành phố hồ chí minh
vonlanthen|von lan thừn
brest|bờ rét
show|sâu
chow-bing|châu binh
ivan|i van
ivar|i va
pct|phó chủ tịch
brookings|bờ rúc kinh
rasmus|rát mút
sky|sờ cai
smartbox|sờ mát boóc
ilkay|in cay
street|sờ chít
capitol|cáp pi ton
abodi|a bô đi
vnu|vê nờ u
ligt|lích
events|i ven
lebanon|lê ba non
delajod|đề la giâu
stefan|sờ tê phan
mascherano|mát sờ ke ra nô
chothirunrungrueng|chô thi run răng răng
nato|na tô
betis|bê tít
vtvgo|vê tê vê gâu
vm|vi em
mozambique|mô dăm bích
djokovic|dô cô vích
kovacic|cô va chích
nature|nây chờ
parameters|pa ra mét tờ
koga|cô ga
unai|u nai
gracias|gờ ra ci át
rodriguez|rô đờ ri ghết
visa|vi sa
meduza|mê đu da
ipomoea|ai pơ mi ơ
budapest|bu đa pét
stuttgard|sờ tút gát
shmona|sờ mô na
gallagher|ga la gơ
oregon|ô rê gôn
trend|tren
palestine|pa lét tin
rafealson|ra pha en sơn
kebangsaan|cơ ban san
zerbi|dơ bi
fair-play|phe pờ lây
southampton|sao tham tơn
espn|i ét pi en
tdtt|thể dục thể thao
port|pót
nice|nai
severodvinsk|sê vơ rô vin sờ
stelimakhovka|sờ te li ma cốp
kh|khách hàng
montreux|môn treo
cope|cốp
ralston|ran sờ tơn
pongracic|pông cờ ra xích
k-pop|cây pốp
karoline|ca rô lai
evaluation|ê va lui ây sờn
vovchansk|vốp chen sờ
benni|ben ni
manaus|ma nau
igla-s|ích lát sờ
queensland|quyn len
cmd|xê mờ đê
innovation|in nô vây sờn
ligue|lích
serbia|xéc bi a
lancaster|len cát tơ
marketing|ma két tinh
shebekino|xe be ki nô
ea|i ây
house|hau
zelensky|de len sờ ki
bqp|bộ quốc phòng
nickel|ni ken
fernandes|phét nan đét
milinkovic-savic|mi li cô vích sa vích
kovalevskaia|cô va lép sờ kai a
dusan|đu san
endre|en đờ rê
oympic|ô lym píc
musiala|mu si a la
jazeera|da di ra
come|căm
rosenau|rô dê nau
amer|a mơ
tyler|tai lơ
bronx|bờ ron xờ
cntt|công nghệ thông tin
wright|roai
koeman|que man
jenner|den nơ
beverage|be vơ rít
game|gêm
internet|in tơ nét
mikel|mi ken
hcv|huy chương vàng
jun|dun
brew|bờ riu
chile|chi lê
abeyi|a bi ây
schmeichel|sờ mai cồ
zakaria|da ca ri a
li-ning|lai ninh
sdgs|ét đi di ét
emc|i em xi
vertonghen|vơ tông ghen
golo|gô lô
showcase|sâu cây
crisis|cờ rai xít
borussia|bô rút xia a
ielts|ai eo
tb|trung bình
pixabay|pi xa bây
kevin|kê vin
ramon|ra môn
korda|cô đa
mattis|ma tít
druze|đờ rút
paderborn|pa đơ bon
queen|quyn
los|lốt
fanpage|phen pết
medsim|mét sim
bbc|bi bi xi
jeschke|dét sờ cơ
rosenberg|rô sen bớc
evo|i vâu
aalborg|an boóc
this|dít
front|phờ răn
images|im mít
aun|an
gabriel|ga bờ rin en
busta|bút ta
johnathan|dô na than
morales|mô ra lét
szczesny|xéc ni
sierro|xi ê rô
days|đây sờ
hydrogen|hai đờ rô den
ballstothis|bô tu dít
epa|i pi ây
well|oeo
d|đi
macron|mác cờ rông
carver|ca vơ
augsburg|au sờ buốc
pablo|páp lô
tabayevka|ta ba de ka
lewandowski|lê goan đao sờ ki
nike|nai ki
eurasia|êu ra si a
tiktok|tích toóc
alferez|an phơ rét
algeria|an giê ri a
lorlatinib|lô la ni níp
watford|oát phót
bremen|bờ rê men
cody|cô đi
russian|rắt sần
vietnam|việt nam
western|goét tờn
amazon|a ma dôn
bury|bơ ri
clare|cờ le
level|le vờ
lille|lin
box-to-box|boóc tu boóc
amherd|am hớt
channel|chen nồ
floderus|phờ lo đơ rớt
bern|bơn
gpu|di pi iu
of|ợp
irrati|i ra ti
vignal|vích nồ
xiv|xi vờ
learning|lơn ninh
pro|pờ rồ
canada|ca na đa
new|niu
chornomorske|co nơ mo sờ cơ
html|ết ti em eo
kyrylo|cơ ri lâu
republique|ri pắp bờ lích
kirill|ki riu
castellanos|cát sờ te lan nốt
nadine|na đin
lothar|lô tha
maire|mai rơ
maatsen|mát sen
paraiso|pa rai sô
brehme|bờ rê mơ
campuchia|cam pu chia
vie|vi e
itlos|ít lốt
karol|ca rôn
liron|li rôn
morena|mô rê na
atp|ây ti pi
fox|phoóc
chiellini|ki e li ni
bosaso|bô sa sô
ferdinand|phơ đi nan
olympia|ô lim pi a
gonzalez|gôn da lét
penh|pênh
beethoven|bét thô ven
onana|ô na na
platini|pờ la ti ni
talksport|toóc sờ pót
pedro|pê đờ rô
peskov|pét sờ cốp
jbl|di bi eo
cafu|ca phu
kishimi|ki xi mi
nhm|người hâm mộ
sputnik|sờ pút ních
a-b|ây bi
malaya|ma la da
invitational|in vi tây sờn nồ
brazil|bờ ra din
cre|cờ re
kong|công
orenburg|ô ren bớc
lpga|eo di pi ây
tcvt|ti xi vi ti
iskander|ít can đơ
bleacher|bờ lít chơ
scholz|sờ câu
europol|ơ rô pôn
breel|bờ riu
hang-seo|hang seo
uav|iu ây vi
place|pờ lết
chhangte|chang tê
pravda|pờ ra vờ đa
usmnt|iu ét em en ti
meissner|mây sờ nơ
evening|i vơ ninh
fiji|phi di
var|vi ây a
dnipro|ni pờ râu
weeze|guy dờ
george|gioóc
national|ne sờn nồ
moder|mâu đơ
schools|sờ kun
post|pốt
fialho|phi an hâu
saso|sa sô
sesko|séc cô
tflops|ti phờ lóp
jong|dong
timite|ti mai
latin|la tinh
toeic|to ích
vtvcab|vê tê vê cáp
darul|đa run
patricia|pa tri xi a
shaqiri|xa quy ri
john|dôn
cristiano|cờ rít ti an nô
clip|cờ líp
nus|en iu ét
novak|nô vác
vafost|va phót
vh-tt-dl|văn hóa thể thao du lịch
hindu|hin đu
sheinbaum|xê in bam
gwynne|oai nơ
africom|a phờ ri com
v-sat|vi sát
press|pờ rét
burgnich|bơ ních
paz|pát
conor|con nờ
lollobrigida|lô lô bờ ri di đa
tolgahan|tôn ga han
veltins-arena|ven tin a re na
livingston|li vinh sờ tơn
seoul|sơ un
telegraph|te le gờ ráp
ipcc|ai xi pi pi
pakse|pác sê
dias|đi át
artur|a tơ
hannan|han nan
ps|pi ét
keir|cơ
gharibabadi|ga ri ba ba đi
soktheara|sốc thia ra
simons|sai mừn
pirlo|piếc lô
andrej|an đờ rây
starokonstantinov|sờ ta rô côn sờ tan ti nốp
ofc|âu ép xi
hallym|ha lim
matthaus|ma thớt
cole|câu
spieth|sờ pít thờ
tits|tít
rossi|rốt si
leonid|lê ô nít
cameroon|ca mê run
south|sao
harry|he ri
athens|a then
kingsley|kinh sờ li
dollar|đô la
jujitsu|du dít su
carolina|ca rô lai na
boat|bốt
love|lớp
kraisorn|cờ rai son
koyama|ko da ma
mejia|mê di a
italia|i ta li a
hacker|hách cơ
rafah|ra pha
rie|ri e
pimakhov|pi ma cốp
vnuhcm|vê nờ u hồ chí minh
vanherck|van héc
engineering|en di nia rinh
news-press|niu pờ rét
quynh|quynh
hernando|héc nan đô
cacc|xi ây xi xi
spief|sờ píp
mcallister|mắc a lít tơ
switzerland|thụy sĩ
gilad|ghi lát
runbiz|run bít
tiegna|tiếc gờ na
kyriakos|ki ri a cốt
ms|em ét
monclova|mông cờ lô va
fordow|pho đừm
cntt-tt|công nghệ thông tin truyền thông
deschamps|đờ cham
cme|xi em i
andre|an đờ rê
mytv|mai ti vi
tw|trung ương
heiko|hê cô
feaser|phia sơ
lucerne|lu xơn
yermak|dơ mác
nicolas|ni cô lát
lukic|lu kích
grassley|gờ rát li
grand|gờ ren
kherson|khia son
pakistan|pa kít tan
grimes|gờ ram sờ
daiki|đai ki
aiff|ây ai ép ép
loke|lô ki
movers|mu vờ
russ|rắt
lacii|la xi
kh-cn|khoa học công nghệ
albania|an ba ni a
mickelson|mi ken sơn
tour|tua
baltic|ban tích
charilaou|cha ri la ô
thcs-thpt|trung học cơ sở trung học phổ thông
rsf|a ét ép
argentina|ác hen ti na
rangel|ren dồ
skau|sờ cau
arena|a ren na
group|gờ rúp
bouchard|bâu chát
pyrolysis|pai rô lai sít
bdap|bi đáp
gill|ghiu
housekeeping|hau kíp pinh
alito|a li tô
athletics|a thờ le tích
kharkov|kha cốp
casper|cát sờ pơ
mannaj|man na
gala|ga la
europa|ơ rô pa
buk|búc
hlv|huấn luyện viên
budimir|bu đi mia
ian|i an
ireland|ai len
duytan|duy tân
english|inh lích
lpbank|lờ pê banh
vgp|vi di pi
neuss|noi sờ
slam|sờ lam
salvador|sa va đo
race|rây
kompany|com pa ni
mq|em kiu
volchanskiye|vôn chan sờ kai
fullkrug|phun rúc
sl|số lượng
donex|đô nếch
social|xâu xồ
dietz|đai ét dờ
lallianzuala|la li ần dua la
saeed|sa ít
women|gua mần
airbus|e bớt
koopmeiners|cúp mây nơ
jenin|de nin
yakin|da kin
politico|pô li ti cô
croatia|cờ roát ti a
dusseldorf|đu sen đóp
ulis|u lít
guterres|gu te rét
vingroup|vin gờ rúp
gantz|gan dờ
zaporizhzhia|da pô ri dia
belgrade|beo gờ rết
buckingham|bấc kinh ham
gaal|gan
hagl|hoàng anh gia lai
iran|i ran
nicolo|ni cô lô
somalia|sô ma li a
sdg|ét di đi
mcstay|mắc sờ tay
namg|nam gờ
nzss|en di ét ét
cee|xi
kjaer|kai ơ
claudia|cờ lau đi a
paris|pa ri
alaska|a lát ca
balkan|ban can
pca|pi xi ây
pionierpanzer|pai ơ nia pen dơ
dailymail|đây li mêu
wp|đắp liu pi
havana|ha va na
ksbp|kiểm soát biên phòng
athletic|a thờ le tích
andrea|an đờ rê a
drone|đờ rôn
olaf|ô láp
chakar|chác ca
alphafly|an pha phờ lai
griezmann|gờ rít man
ippg|ai pi pi di
vannes|van nét
volchansk|vâu chan
ch|xê hát
ibrahim|i bờ ra him
umb|iu em bi
mena|mê na
clinton|cờ lin tơn
bastille|bát sờ tiu
nykvist|nai cờ vít
fan|phen
torres|to rét
nebulosus|nê bu lâu sớt
gianluigi|gian lu di
mcilroy|mắc iu roi
andriano|an đờ ri an nô
ctv|xi ti vi
ismail|ít sờ mêu
ivana|i va na
chiker|chi cơ
unesco|iu nét sờ cô
trivium|tri vi um
soucek|sô chéc
istanbul|ít tan bun
taxi|tắc xi
dayot|đa dốt
jurgen|du ghen
congo|công gô
brics|bờ rích
pte|pi ti i
leonardo|lê ô nác đô
anthony|an tô ni
pusan|pu san
leberwurst|le bơ gút
dzhankoy|dờ han coi
tuyendungvn|tuyển dụng vi en
mitaj|mi tai
techcombank|tếch com banh
fearless|phia lớt
wharton|goa tơn
florence|phờ lo ren
mm|em em
navsea|náp xi
portman|pót men
homestay|hôm sờ tay
vec|véc
rica|ri ca
grealish|gờ ria lít
rq|rờ quy
ruben|ru ben
mazlan|mát lan
swp|ét đắp liu pê
manila|ma ni la
kt-xh|kinh tế xã hội
is|i ét
jordan|gioóc đan
staromaiorske|sờ ta rô ma giốc ke
messi|mét si
slna|sông lam nghệ an
ib|ai bi
carribe|ca ri bê
bukayo|bu ka dô
persic|pơ xích
rome|rôm
cambiaso|cam bi a dô
pickleball|pích cồ bôn
qassam|qua sam
sameh|sa mê
youtuber|diu túp bơ
hilal|hi la
golan|gô lan
wto|đắp liu tê ô
bergepanzer|bơ di pen dơ
porteous|po tơ ớt
slovenia|sờ lô ve ni a
gerd|ghét
ii|i i
bp|bi pi
world|uốt
sandy|sen đi
christiaan|cờ rít ti an
johnson|dôn sơn
tutor|tiu tờ
houston|hu sờ tơn
logic|lô dích
mitsotakis|mít sô ta kít
ub|iu bi
sls|ét eo ét
reijnders|rên đơ
european|ơ rô pi ần
federico|phe đơ rích cô
flip|phờ líp
mounir|mâu nia
mohammed|mô ha mét
victoria|vích to ri a
gross|gờ rót
troussier|tru di ê
erick|e rích
soutsada|sâu sa đa
armenia|ác mê ni a
anton|an tơn
vietcombank|việt com banh
chaubey|chau bây
genai|den ây ai
brooke|bờ rúc ki
banana|bờ ne nờ
vyacheslav|via chét sờ láp
tierney|tơ nây
strakosha|sờ tra cô xa
q|kiu
indeed|in đít
higher|hai gờ
fptplay|ép pê tê pờ lây
scottie|sờ cót ti
wsj|đắp liu ét di
chat|chát
mc|em ci
savanakhet|sa va na khét
kiwior|ki guy ơ
steinmeier|sờ tên mây ơ
atlanta|át lan ta
boninsegna|bô nin séc na
dimarco|đi mác cô
size|sai
stephen|sờ te phừn
scotland|sờ cốt len
sik|xích
qa|kiu ây
thiago|thia a gô
maximilian|mắc xi mi li an
sherwood|xơ út
florida|phờ lo ri đa
mig|mích
grafite|gờ ra phít
olympiastadion|ô lim pi a sờ tây đừn
gur|gu
aebischer|e bít chơ
axios|a xi ốt
cev|xê e vê
verbruggen|vơ bờ ru ghen
huguette|hu ghét tê
angel|en dồ
bungari|bun ga ri
graham|gờ ra ham
jerusalem|dê ru sa lem
phengphachanh|phênh pha chanh
dani|đa ni
from|phờ rom
ac|ây xi
charlotte|cha lót te
flyers|phờ lai ơ
roitman|rót man
vrij|vơ ri dờ
smarttv|sờ mát ti vi
mario|ma ri ô
afp|a ép pê
amad|a mát
copy|cóp pi
observer|óp dơ vờ
swat|sờ goát
dominguez|đô min goét
swiss|sờ guýt
glome|gờ lôm
manuel|ma nu en
bch|ban chấp hành
dijk|đai
shinken|xin ken
african|a phờ rin cừn
plus|pờ lớt
club|cờ láp
set|sét
aa|a a
pinto|pin tô
saravia|sa ra vi a
hill|hiu
tenku|tên cu
cbs|xi bi ét
cienco|xi en cô
rafa|ra pha
aun-qa|an qua
report|ri pót
newsnation|niu sờ nây sờn
nn|en en
kristersson|cờ rít sờ tơ sơn
hardestgeezer|hát đít ghi dơ
fotmob|phút móp
gilles|ghiu lét
pgs-ts|phó giáo sư tiến sĩ
swinney|sờ uyn ni
medvedev|mét ve đép
scamacca|sờ ca mác ca
dembele|đem bê lê
duma|đu ma
kiev|ki ép
edu|e đu
tiger|tai gơ
lavrov|la vờ rốp
chatgpt|chát di pi ti
wilander|goai len đờ
california|ca li phoóc ni a
shark|xác
haniyeh|ha ni e
idf|ai đi ép
gelsenkirchen|gen sen cơ chen
chelsea|chen xi
data|đa ta
kurd|cút
havertz|ha vớt
andrew|an đờ riu
jairo|dai rô
iq|ai kiu
nelly|ne li
heroin|hê rô in
seferi|xe phe ri
gerometta|ghê rô mê ta
arabia|a ra bi a
bournemouth|bon nơ mớt
slavyansk|sờ la vi ang
nexxus|nếch sút
koujinkai|cô din kai
solving|sâu vinh
vasily|va si li
reims|rem sờ
fas|phát
module|mô đun
garden|ga đờn
becamex|bê ca mếch
abbas|a bát
namer|nêm mờ
stergiou|sờ tơ di ô
schauffele|sờ kau phê lê
otamendi|ô ta men đi
blockchain|bờ lóc chên
edin|ê đin
luciano|lu xi a nô
survation|sơ vây sừn
pennsylvania|pen si va ni a
the_wrong_side|dơ roong sai
road|rốt
liechtenstein|lếch ten sờ tanh
dna|đi en ây
lihue|li huê
szoboszlai|sờ dô bô lai
janoub|da nốp
probierz|pờ rô bai ơ
morata|mô ra ta
mykhailo|mi khai lô
gohardasht|gô ha đát
afd|ây ép đi
karakurt|ca ra cút
gus|gút
usns|iu ét en ti
omer|ô mơ
barnheart|ban hớt
sonar|sô na
marcelo|mác xê lô
pathum|pa thum
asia|ây di ờ
panorama|pa nô ra ma
shibuno|xi bu nô
firdauz|phia đâu
concerto|con xớt tô
vladimir|vờ la đi mia
dreamliner|đờ rim lai nơ
aberg|a bớc
fidan|phi đan
old|âu
nuri|nu ri
et|i ti
futures|phiu chờ
broja|bờ rô da
brooks|bờ rúc
valentin|va len tin
khalifa|kha li pha
rozzifireworks|rô di phai guốc
coca|cô ca
pad|pát
bajrami|ba dờ ra mi
defense|đi phen
zelaya|de la da
abdoulaye|áp đâu la dê
scofield|sờ cót phiu
schafer|sờ cha phơ
mofa|mô pha
management|men nít mần
football|phút bôn
justin|dát tin
uae|u a e
altman|an man
molina|mô li na
sahara|sa ha ra
zaporozhye|da pô rô hia
livesport|li vờ sờ pót
indian|in đi ần
bosnia|bốt ni a
because|bi cớt
mexico|mê xi cô
natural|ne chờ
huye|hi ê
starmer|sờ tam mờ
liberia|li bê ri a
fanapage|phen pết
ecuador|ê cua đo
milik|mi lích
endrick|en đờ rích
bie|bi ê
gd|gia đình
hansi|han si
hernandez|héc nan đét
toefl|tóp phồ
palisa|pa li sa
ciu|xiu
metsola|mết sô la
horn|hon
adidas|a di đát
naval|na van
jack|dách
volodymyr|vô lô đi mia
anatoly|a na tô li
ehud|e hút
stojkovic|sờ tô cô vích
kieran|ki ê ran
fussballliebe|phút bô li ê bê
express|ích pờ rét
thompson|thom sơn
roy|roi
capello|ca pê lô
kiraz|ki rát
johor|do hơ
yury|du ri
maillard|mêu lát
shangri-la|sang ri la
endin|en đin
sidhom|sít hom
lampard|lam pát
irin|i tin
mikhail|mi kha in
moskva|mát cơ va
unclos|ăng lốt
kenya|ken da
studennikov|sờ tiu đần ni cốp
bt|bi ti
mar-a-lago|ma a la gô
jersey|dơ xi
tesla|tét la
brexit|bờ re xít
mma|em em ây
pittsburgh|pít buốc
trippier|chíp pi ơ
palm|pam
sommer|som mơ
celtic|xen tích
ake|a kê
kwadwo|qua đô
yong|dong
tebas|tê bát
moscow|mát sờ cơ va
farage|pha rác
lithuania|li thua ni a
pellistri|pê lít tri
modric|mô đờ ríc
campinas|cam pi nát
elon|ê lon
assurance|ét sua rừn
ibt|ai bi ti
muci|mu xi
holman|hâu man
us|iu ét
warren|goa ren
savanta|sa van ta
mobile|mô bai
afghanistan|áp phờ ga nít tan
klum|cờ lum
mitrovic|mi trô vích
iron|i ờn
fa|ép ây
fedex|phe đếch
buksa|bút sa
knapper|náp pơ
orkesh|o két
spotv|sờ po ti vi
bayeux|bay ớt
soda|sô đa
antonov|an tô nốp
caribe|ca ri bê
gulacsi|gu lác si
asensio|a sen xi ô
pep|pép
jae-myung|de mi ung
zimbabwe|dim bao buê
virus|vai rớt
netflix|nét phờ lích
jaspers|dát pơ
nations|nây sờn
benz|ben dờ
ev|i vi
jeremy|de rơ mi
roja|rô da
tngt|tai nạn giao thông
hassan|hát san
acropolis|ác cờ rô pô lít
kanal|ca nan
axit|a xít
cardoza|ca đô da
radar|ra đa
abdulqadir|áp đun qua đi
feyenoord|phây nót
zagreb|da gờ rép
isw|ai ét đắp liu
pomphan|pom phan
wirtz|vớt
jacob|da cốp
honolulu|hô nô lu lu
pavlo|páp vờ lô
market|mác két
alan|a lan
taekwondo|te uôn đô
ibiza|i bi da
hit-to-kill|hít tu kiu
reshetnikov|re xen ni cốp
silva|xiu ca
yaetsubaki|da e tờ su ba ki
rajamangala|ra da man ga la
remo|rê mô
ewing|e guynh
rublev|ru bờ lép
liga|li ga
weibo|uây bô
kobbie|cô bi
echo|e cô
asllani|át lan ni
ranking|ranh kinh
tod|tót
snowden|sờ nâu đần
gary|ghe ri
rule|ru
ie|i e
virginia|vơ din ni a
cna|xi en ây
daily|đây li
peic|péc
stockhom|sờ tốc khôm
android|an đờ roi
merkava|mơ ca va
majer|mai ơ
gazprom|gát pờ rom
gareth|ga rét
florian|phờ lo ri an
was|uốt
zaporizhia|da pô ri dia
wolmirstedt|ua mia sờ tét
iaea|ai ây i ây
verbana|vơ ba na
lining|lai ninh
byd|bi goai đi
schar|sờ ca
duncan|đun can
gdpt|giáo dục phổ thông
vivaland|vi va len
gis|ghít
philippe|phi líp pê
novosti|nô vốt ti
kyrgios|ki giốt
sandhu|sen hu
tivi|ti vi
ukmto|ưm tô
fi|phi
raqqa|rác qua
rice|rai
times|tham
web|oép
nssc|en ét ét xi
hayatt|ha dát
weisswurst|uây hót
ptnt|phát triển nông thôn
kozoom|co dum
david|đa vít
gallas|ga lát
greenwood|gờ rin út
polaris|pô la rít
cyber|xai bơ
adam|a đam
sandra|san đờ ra
vovinam|vô vi nam
andriy|an đờ ri
seversk|sơ véc
pierre-emile|pia ê e mi lê
hotel|hô theo
scheffler|sờ ke phờ lơ
ulsan|un san
frank-walter|phờ ranh oan tơ
aerovironment|e râu vai rờn mần
petkovic|pét cô vích
cdc|xi đi xi
gorshkov|go sờ cốp
soreide|sô rây đê
mukdahand|múc đa hen
security|se kiu rơ ti
rochester|râu chét tơ
villa|vi la
larry|le ri
sancho|san chô
bukele|bu kê lê
ttk|tổng thư ký
koepka|quét ca
halong|hạ long
richard|ri chác
javier|da vi ơ
sunn|săn
nico|ni cô
frost|phờ rót
tuabin|tua bin
voucher|vo chơ
nhie|nhi ê
london|lôn đôn
hanoi|hà nội
pc|pi xi
yushkov|dút cốp
whatsapp|goát sờ áp
alain|a lên
penderecki|pen đơ réc ki
witchayanon|uýt cha da non
rashid|ra xít
eriksen|e rích xen
michigan|mi chi gân
spacex|sờ pây ích
usv|iu ét vi
secundaria|sê cun đa ri a
foundation|phao đây sờn
gaucho|gau chô
nvcc|nhân vật cung cấp
piatek|pi a tếch
geely|ghi li
bayern|bay ơn
lucas|lu cát
inter|in tơ
zelenksy|de len sờ ki
https|ết ti ti pi ét
donnarumma|đôn na ru ma
mccoist|mắc coi
yevlash|de vờ lát
pearson|pia sơn
ineos|i nê ớt
milan|mi lan
caltech|can tếch
belbeck|ben bếch
zhang|dang
turpin|two pin
inverted-wingback|in vớt tựt guynh bách
mctominay|mắc tô mi nây
samayoa|sa ma doa
hemme|hem mê
koke|cô kê
tournament|tua nơ mần
zivkovic|di vờ cô vích
vodolatsky|vô đô lát sờ ki
twitter|twof uýt tơ
ep|ép
moy|moi
jonas|dô nát
apho|ây pi ết âu
zelenskiy|de len sờ ki
guantanamo|guan ta na mô
dtu|đi ti iu
netanyahu|nết ta nia hu
daleep|đa líp
bob|bốp
shia|xia
patriot|pa tri ốt
benjamin|ben da min
sanaa|sa na
hawaii|ha oai
vff|vi ép ép
institute|in sờ ti tiu
chris|cờ rít
l|eo
josko|dốt cô
josip|dô síp
nhs|nờ hát ét
huit|hui
gyeong-a|ghi ê ông a
hubner|húp nơ
bednarek|bét na rếch
union|iu ni ần
ads-b|ét bi
n|en
pv|phỏng vấn
town|thao
freuler|phờ rêu lơ
francis|phờ ran xít
tn-mt|tài nguyên mô trường
werder|uây đơ
back|bách
berlin|béc lin
tmu|tê mờ u
tottenham|tốt tên ham
leipzig|lép dích
shms|ét hát mờ ét
barca|bác xa
hebron|hơ bờ ron
nedim|nê đim
aymeric|a mê rích
wilcox|uyn cót
bhxh|bảo hiểm xã hội
carl|can
ts-bs|tiến sĩ bác sĩ
singer|sinh gờ
himars|hi ma
herzogenaurach|hơ dô ghê nau rách
nikolai|ni cô lai
denis|đê nít
reuters|roi tơ
bolla|bô la
gravenberch|gờ ra ven ben
gripen|gờ ríp pừn
slisz|sờ lít dờ
hinako|hi na cô
hojlund|hô lun
gakpo|gác pô
nagelsmann|na gen sờ man
zdf|dét đi ép
mariupol|ma riu pôn
planes|pờ lên
saxony-anhalt|sác xô ni an hao
lorenzo|lô ren dô
astrakhan|át tra khan
pis|pít
monitoringwar|mo ni tơ rinh oa
andy|en đi
troy|choi
gvardiol|gờ va đi on
jerkovic|dơ cô vích
romelu|rô mê lu
llorente|lô ren tê
el|eo
nantes|nan tê
rapid|ra pít
development|đe ve lốp mần
castro|cát trô
bilbao|bin bao
donetsk|đô nét
khie|khi ê
fernando|phét nan đô
sydney|xít ni
matsuyama|mát su da ma
tiki-taka|ti ki ta ca
meta|mê ta
daniel|đan ni eo
city|xi ti
geezer|ghi dơ
unmiss|ăn mít
good|gút
adizero|a đi dê rô
junseikai|dun sê cai
sebastian|sê bát ti an
euro|ơ rô
bergmann|bớc gờ man
patin|pa tanh
rusi|ru xi
studeman|sờ tút man
josep|dô xép
facundo|pha cun đô
upitt|u pít
vn|việt nam
pinpoint|pin poi
golf|góp
tedesco|te đét cô
nego|nê gô
alexander-arnold|a lếch xan đơ ác nôn
htf|hát tê ép
costa|cốt ta
kursk|cút
scb|ét xi bi
ceo|xi i âu
startup|sờ tát ắp
frank|phờ ranh
jean|din
ramadani|ra ma đa ni
kaen|ken
camp|cam
ashworh|át uốt
ttxvn|thông tấn xã việt nam
yevpatoria|ép pa tô ri a
belarus|bê la rút
vck|vòng chung kết
hawkstone|hoóc sờ tôn
kleinheisler|cờ lây hây sờ lơ
rostec|rốt téc
emiliano|e mi li a nô
moon|mun
oman|ô man
billiards|bi a
nation|nây sờn
depay|đì pây
spiel|sờ pi en
steven|sờ ti phừn
il|iu
darmian|đa mi an
metula|mê tu la
sylvinho|xi vi nhô
norwich|nót uých
park|pác
maryland|me ri len
scouser|sờ cau sơ
ir|i
artem|a tem
nttu|en ti ti iu
marc|mác
hat-trick|hát chích
michael|mai cơn
ubkttw|ủy bản kiểm tra trung ương
fulbright|phun bờ rai
bihr|bia
istorage|ai sờ to rít
mckenna|mắc ken na
romania|rô ma ni a
health-focus|heo phâu cớt
survival|sơ vai vồ
shin|xin
scotsman|xờ cót man
fairway|phe uây
nayib|nai bíp
maui|mau ui
authority|au thơ ri ti
vnpt|vi en pi ti
birdie|bớt đi
bedouin|bê đâu in
totalenergies|tô ta lê e nơ di
muhammad|mu ha mát
goley|gô lây
sat|ét ây ti
israel|ít sa ren
pedri|pê đờ ri
al|an
lyon|li ông
khon|con
yusov|du sốp
robert|rô bớt
amdouni|em đâu ni
franz|phờ ran
ahmed|a mét
roland|rô lan
merckx|mớc
hendry|hen đờ ri
samsung|sam xung
pac|pác
bornholm|bon nhôm
golubev|gô lu bớp
kylian|ki li an
alive|ơ lai
luke|lúc
china|chai nờ
masatada|ma sa ta đa
rafaelson|ra pha en sơn
pansa|pan sa
kremensky|cờ re men sờ ki
tt-tt|thông tin truyền thông
aleksandar|a lếch san đa
dominic|đô mi ních
thcs|trung học cơ sở
hague|ha ghuê
jun-tae|dun ta ê
chatham|cha tham
caas|xi ây ây ét
mats|mát
bates|bết
philippines|phi líp pin
lion|lai ần
oliver|ô li via
clement|cờ lê mần
fumitake|phu mi ta kê
hello|hê lâu
tal|tao
busquets|bút sờ quét
tagueu|ta guê
subic|su bích
challenge|che lần
cmp|xi em pi
uefa|u ê pha
kozlowski|cô lâu sờ ki
camera|ca mê ra
kurilla|cu ri la
hie|hi ê
square|sờ que
plaza|pờ la da
hurfeish|hơ phây sờ
college|co lít
telecom|te le com
masters|mát tơ
htv|hát tê vê
dapur|đa pơ
marie|ma ri
guatemala|goa tê ma la
catherine|ca thơ rin
lahm|lam
rivaldo|ri van đô
qr|quy rờ
kaman|ca man
carvajal|ca va han
christian|cờ rít ti an
bryansk|bờ ri ang
bulgaria|bun ga ri a
beckham|béc khăm
almutari|an mu ta ri
ioannidis|i oan ni dít
erik|e rích
siberia|si bê ri a
tokai|tô kai
fdi|ép đê i
inch|inh
paul|pôn
alvarez|an va rét
ayman|ây man
nick|ních
chie|chi ê
tt|tê tê
shoigu|sôi gu
vh-tt|văn hóa thể thao
joe|dâu
genesis|den nơ sít
monash|mô nách
acer|ây xơ
magdeburg|mác đơ bớc
uk|iu cây
preliminary|pờ rơ li mơ ne ri
children|chiu rừn
nationalelf|nây sờn nồ lớp
livakovic|li va cô vích
barcelona|bác xê lô na
bidv|bi ai đi vi
celso|xen xô
partizan|pa ti dan
nbs|en bi ét
pages|pết
atgt|an toàn giao thông
halevi|ha lê vi
embolo|em bô lô
rory|rô ri
dw|đê đắp liu
lng|eo en di
zhiwei|di guây
vga|vê gờ a
hagen|ha ghen
wisent|uy xen
gpudirect|di pi iu đai rếch
slovakia|sờ lô va ki a
maksimovic|mác si mô vích
rahim|ra him
nikkei|ních cây
sea|xi
yassin|da xin
merino|mê ri nô
lamphouvong|lem phâu vông
oniks|ô ních
iten|ai tên
kavacic|ca va xích
cerundolo|xê run đô lô
g|di
max|mắc
ipswich|íp sờ guých
kane|kên
music|miu dích
niclas|ních lát
spirit|sờ pi rít
yasen-m|da sen em
olmo|ôn mô
joseph|dô sép
bayindir|ba din đia
chxhcn|cộng hòa xã hội chủ nghĩa
siles|si lét
professional|pờ rô phét sờn nồ
food|phút
paige|pai dờ
zlatko|dờ lát cô
cup|cắp
facebook|phây búc
pasteur|pát tơ
application|áp pờ li cây sờn
dnnn|đi en en en
benfica|ben phi ca
entrepreneur|an chơ pờ rơ nua
naver|na vơ
vinicius|vi ni xi ớt
vnexpress|vi en ích pờ rét
ronaldinho|rô nan đi nhô
itp|ai ti pi
harris|ha rít
windsor|uyn sơ
faeser|phây dờ
hag|hác
gotland|gót len
brisard|bờ ri sát
stockholm|sờ tốc khôm
maguire|mắc gai
volley|vô lây
cty|công ty
hust|hút
app|áp
pvf|pê vê ép
lukaku|lu ca ku
fid|ép i đê
ldg|lờ đê gờ
aerosystems|e râu sít từm
qs|kiu ét
alpine|an pai
rkw|rờ ca đắp liu
future|phiu chờ
ruediger|ru đi gơ
davos|đa vốt
myeong-jong|mi ông dong
jordi|gioóc đi
kazan|ca dan
gallant|ga lan
boris|bo rít
champions|chem pi ần
ryan|rai ần
shotwell|xót goeo
java|da va
nbc|en bi xi
jan|dan
statista|sờ ta tít ca
wolfin|uốp phin
bql|ban quản lý
hmcs|hát mờ xê ét
ralf|ráp
jay|day
cyprus|síp
sudan|su đăng
asani|a sa ni
year|dia
verkhovna|vơ khốp na
bruno|bờ ru nô
citizen|xi ti dần
wassem|oa xem
guehi|gu ê hi
estonia|ét tô ni a
marquette|mác quét
swan|sờ goan
mbbank|mờ bê banh
had|hét
bakhmut|bác mút
giroud|di ru
sunday|săn đây
training|trên ninh
ross|rót
merics|mê rích
jannik|dan ních
aud|âu đờ
honduras|hon đu rát
trent|chen
ichiro|c chi rô
leavitt|lê a vít
chemezov|chê mê dốp
graz|gờ rát
cm|cách mạng
rn|rờ nờ
seg|séc
ledwidge|lét uých
dell|đeo
cnch|cứu nạn cứu hộ
karbala|ca ba la
cut-off|cắt ọp
havert|ha vớt
albiceleste|an bi ce lét te
diallo|đi a lô
angola|ăn gô la
jude|dút
tel|teo
website|oép sai
stansstad|sờ ten sờ tát
a-level|ây le vồ
ptsd|pi ti ét đi
emre|em rê
tuyensinh|tuyển sinh
duah|đua
titan|ti tan
evn|e vê nờ
starters|sờ tát tơ
hideki|hi đe ki
baena|ba ê na
pgs|phó giáo sư
hagl-jmg|hoàng anh gia lai di em di
oranje|o rên di
serie|sê ri
nordea|no đia
tajani|ta da ni
kremlin|cờ rem lin
tehran|tê ran
allegri|a lê gờ ri
yaari|da a ri
nampt|nam pi ti
getty|ghét ti
hamas|ha mát
ubnd|ủy ban nhân dân
rodrigues|rô đờ ri ghết
jung-han|dung han
hills|hiu
nominated|no mi nết tựt
singh|xinh
academy|a ca đe mi
ronaldo|rô nan đô
alba|an ba
massimiliano|mắc xi mi li a nô
mrna|mơ na
kaulitz|cau lít
ringgit|rinh ghít
time|tham
martinez|mác ti nét
idzes|ít di
qatar|ca ta
mcginn|mắc ghin
joao|doan
restaurant|rét tau rần
muenchen|mu en chen
ayoze|a dô di
petar|pê ta
johansson|do han sơn
syria|si ri a
varga|va ga
podcast|pốt cát
odaisseh|ô đai sê
playstation|pờ lây sờ tây sờn
calderoli|can đê rô li
cameron|ca mê run
aids|ết
dj|đi dây
surakarta|su ra ca ta
yair|dai rờ
scaloni|sờ ca lô ni
jong-un|dong un
it|ai ti
oblak|ô bờ lác
up|ắp
icao|i cao
gascoigne|gát côi
letexier|le tơ xi ơ
noury|nâu ri
holligan|hu li gân
z|dét
fiola|phi ô la
hodeida|hô đây ra
savannakhet|sa van na khét
seirei|sơ rây
yuriy|du ri
board|bốt
tsav|ti sáp
gaie|gai ê
benny|ben ni
abc|ây bi xi
wimmen|uym men
saint|xanh
hanley|han lây
bib|bíp
kuwait|ku oát
sunny|săn ni
alessandro|a lếch xan đờ rô
domenico|đô me ni cô
nguyen|nguyễn
gunn|găn
gaza|ga da
ferran|phơ ran
zuber|du bơ
donbass|đôn bát
al-ettifaq|an ê ti phát
teddy|tét đi
sachsen-anhalt|sa chen an hát
bluetooth|bờ lu tút
pinocchio|pi nô chi ô
hezbollah|hê bô la
mcgregor|mắc gờ re gờ
idp|ai đi pi
stem|sờ tem
kante|can tê
a-on|ây on
tasmania|tát ma ni a
terengganu|tê rên ga nu
mateo|mát tê o
nexstar|nếch sờ ta
nole|nô lê
bumbelo|băm bê lô
google|gu gồ
tnt|ti en ti
enzo|en dô
adios|a đi ốt
culinary|cu li ne ri
xiaoxiang|xi ao xiêng
nyt|niu oóc tham
ibara|i ba ra
luis|lu ít
hopkins|hóp kin
botka|bốt ca
hcm|hồ chí minh
jamal|da man
vodiane|vô đia nê
zubimendi|du bi men đi
hoasen|hoa sen
vtv|vê tê vê
mis|mít
giornale|di ô nêu
fumio|phu mi ô
foden|phâu đừn
arouri|a râu ri
breitner|bờ rết nơ
frenkie|phờ ranh ki
swinburne|sờ uyn bơn
mallorca|ma loóc ca
bolivia|bô li vi a
baking|bếch kinh
benitez|ben ni tét
vinaphone|vi na phôn
suriname|sơ ri nêm
sport|sờ pót
black|bờ lách
geographic|di o gờ ra phích
ine|i ne
volodin|vô lô đin
witsel|uýt seo
chasov|cha sốp
mdl|em đi eo
virgil|vơ dồ
vremivka|vơ rê míp ca
christie|cờ rít ti
girona|di rô na
almas|an mát
antony|an tô ni
arwu|a gu
impact|im pách
acerbi|a xơ bi
pfebve|phép vờ
pembrolizumab|pem bờ rô li du máp
tnhh|trách nhiệm hữu hạn
calhoun|can hâu
bastoni|bát tô ni
landover|len đô vơ
eberl|e bơ
khutora|khu tô ra
potter|pót tơ
ict|ai xi ti
rocket|róc két
texas|tếch xát
william|uy li am
viola|vi ô la
djibouti|đi bâu ti
nlrb|nờ lờ rờ bê
cbf|xi bi ép
iceland|ai len
ipad|ai pát
natanz|na tan
samp|sam pờ
nadal|na đan
topik|tô pích
sergio|séc giô
elite|e lít
mercedes|méc xe đét
sallai|sa lai
rawi|ra uy
esl|i ét eo
tobias|tô bi át
lautaro|lau ta rô
players|pờ lây ơ
tzav|tờ dáp
yoav|dô áp
gurion|gu ri ông
afreeca|a phờ ri ca
hunter|hăn tơ
link|linh
psv|pi ét vi
hceres|ết ci e rết
thorsteinsson|tho sờ tanh sơn
kougyo|cô ghi ô
filip|phi líp
bundesliga|bun đét li ga
donghae|đông he
robertson|rô bớt sơn
tjoe|chu ô
led|lét
mac|mắc
qur|quơ
blv|bình luận viên
peels|piu
varanus|va ra nớt
lumpur|lăm pua
sullivan|su li vân
running|răn ninh
rosneft|rốt nép
news|niu sờ
asian|ây di ần
merkur|mây cơ
stoltenberg|sờ tôn ten bớc
willy|ghiu li
viktor|vích to
anwar|an gua
reus|roi
crcs|xê rờ xê ét
marywilska|me ri uyn sờ ca
henderson|hen đơ sơn
perez|pê rét
marshall|ma san
runner|răn nơ
szambowski|sam bâu sờ ki
paju|pa du
dealroom|diu rum
crimea|cờ rưm
alahrak|a la rắc
minnesota|mi nê sô ta
shevchenkivsky|sép chen kíp sờ ki
kramatorsk|cờ ra ma tóc
muscat|mút cát
nv|nhân vật
german|dơ mừn
bendtner|bét nơ
mauricio|mau ri xi ô
wurst|gút
terziv|tơ díp
hamid|ha mít
tand|tóa án nhân dân
tah|ta
cp|chính phủ
micro|míc
kfar|cờ pha
francois|phờ ran côi
bahrain|ba ranh
azzurri|a du ri
clarivate|cờ le ri vết
khmer|khơ me
neymar|nê ma
veerman|via man
amsterdam|am sờ téc đam
mccarthy|mắc cát thi
oxford|oóc phớt
granit|gờ ra nít
germain|dơ mên
vincent|vin xen
asean|a sê an
arop|a rốp
hybrid|hai bờ rít
magazine|me gơ din
kazem|ca dem
bernardino|béc nan đi nô
muller|mu lơ
henrique|hen rích kê
hojbjerg|hoi bớc
commanders|com men đờ
for|pho
nacho|na chô
aic|ây ai xi
space|sờ pây
adisak|a đi sắc
italy|i ta li
mirror|mi rờ
eso|e sô
naif|nai phờ
usaid|iu ét ết
elias|ê li át
energy|e nơ di
taipei|tai pây
musk|múc
international|in tơ ne sờn nồ
play-off|pờ lây ọp
editor|e đít tơ
motion-blur|mâu sờn bờ lơ
selangor|sê lăng gô
giorgio|gioóc giô
kehl|kê
forbes|pho bớc
thpt|trung học phổ thông
cerezo|xê cê dô
games|gêm
paddy|pét đi
cace|cây xi
hully|hu li
rudiger|ru đi gơ
kinsey|kin sây
thomas|thô mát
howard|hoóc uốt
poeiphimai|phây phi moai
kdc|cây đi xi
ikhsan|ích san
aptis|áp tít
bain|bên
dana|đa na
jose|giô sê
major|mây dờ
nis|nít
antonio|an tô ni ô
scott|sờ cót
angeles|an giơ lét
ritz|rít
mueller|mu lơ
jian|di an
muay|muây
agus|a gớt
jesus|dê sút
havryliuk|háp ri lúc
point|poi
education|e diu câ sờn
vitaliy|vi ta li
frankfurt|phờ ranh phuốc
lexi|lê xi
ts|tiến sĩ
archimedes|ác si mét
milenkovic|mi len cô vích
covid|cô vít
portland|pót len
growth|gờ râu thờ
kann|can
austin|au sờ tin
jamaran|da ma ran
net|nét
knoll|cờ non
abet|a bét
scottish|cờ cót tít
rheinland|rên len
soeng|sô en
taketou|ta kê tâu
morozovsk|mô rô dốp
tyc|ti goai xi
golfer|góp phơ
btr|bi ti a
sloc|sờ lóc
osaka|ô sa ca
marco|mác cô
hashtag|hát tác
nicosia|ni cô si a
orban|o ban
yochai|dô chai
azov|a dốp
dachs|dách
villas|vi lát
cnbc|xi en bi xi
hattrick|hát chích
review|ri viu
santos|san tốt
cahn|công an hà nội
nagy|na ghi
normand|no man
cucurella|cu cu re la
america|ơ me ri cờ
malaysia|ma lay xi a
chip|chíp
phnom|pờ nom
retegui|rê tê ghi
columbia|cô lôm bi a
cemb|xép
ally|ơ lai
uterloo|u tơ luu=
bfc|bi ép xi
ana|a na
microsoft|mai cờ rô sóp
fat|phét
pepe|pê pê
srecko|sờ réc cô
brooklands|bờ rúc len
duke|đúc
ronny|rôn ni
tuttomercato|tu tô mơ ca tô
carlo|các lô
pacific|pa xi phích
denys|đe nít
spalletti|sờ pa lét ti
night|nai
yahya|gia da
atmosfear|át mốt phia
jim|dim
cristante|cờ rít từn tê
remiro|rê mi rô
psg|pi ét di
iraq|i rắc
splash|sờ pờ lát
ix|ích
martino|mác ti nô
cabin|ca bin
lovric|lo vờ rích
othman|ót man
fabian|pha bi an
concacaf|côn ca cáp
camilla|ca mi la
tcm|tê xê mờ
wael|oa e
bogey|bô gây
opinium|óp pi ni ừm
gs|giáo sư
saudi|sau đi
ss|ét ét
cultural|câu chờ rờ
technique|téc ních
nord|nót
soweto|sô uê tô
axel|a xeo
burgenstock|bơ gừn sờ tốc
hutech|hu tếch
pharmacy|phạc ma xi
reutlingen|râu linh ghên
australia|ốt xờ trây li a
bg|bi di
eddy|ét đi
naglsmann|na ghen sờ man
msn|em ét en
lopez|lô pét
wfp|đắp liu ép pi
generative|den nơ rơ típ
ferrari|phe ra ri
olancho|ô lan chô
sorbonne|so bơn
tn|tê nờ
beirut|bây rút
gundogan|gun đô gan
bri|bờ ri
volodymir|vô lô đi mia
kuala|coa la
fedorenko|phê dô ren cô
maestro|ma ét trô
dragan|đờ ra gan
brasilia|bờ ra di li a
uss|iu ét ét
navas|na vát
zircon|dia con
jasir|da xia
enrique|en rích kê
pikhota|pi khô ta
intel|in teo
wakrah|oa rác
berkeley|béc cơ li
martin|mác tin
zealand|di lân
bologna|bô loóc na
sporting|sờ pót tinh
cook|cúc
rubella|ru bê la
kasper|cát pơ
sinner|xin nơ
tv|ti vi
miami|mi a mi
gnh|giao hàng nhanh
donno|đôn nô
dardai|đa đai
science|sai ần
lula|lu la
sg|sài gòn
detroit|đê troi
leverkusen|le vơ lu sen
marienplatz|ma ri en pờ lát
office|óp phít
nigeria|nai dê ri a
liverpool|li vơ pun
lloyd|loi
salman|san man
arkadiusz|a ka đi út
oau|oa
vinny|vin ni
sir|sơ
tuchel|tu khồ
derby|đờ bi
andorra|an đô ra
tikhoye|tích hâu ê
aston|át tơn
esm|e ét mờ
oakland|oác lần
romeo|rô mê ô
residence|re di đừn
karaj|ca rác
carom|ca rom
thanhnien|thanh niên
non-professional|năn pờ rô phét sờn nồ
armbar|am ba
ashdod|át đót
rodri|rô đờ ri
kacper|các pơ
andrii|an đờ ri
podolyak|pô đô li ác
carboni|các bon ni
morey|mo rây
gate|ghết
michy|mi ki
lionel|lai ô neo
gullit|gu lít
jake|dếch
mini|mi ni
phil|phiu
kupyansk|ku pi ăng
putin|pu tin
united|iu nai tựt
rodrygo|rô đờ ri gô
leony|lê ô ni
chaktomuk|chát tô múc
iryna|i ri na
andreas|an đờ rê át
luar|lua
veljkovic|veo cô vích
moldova|môn đô va
azriey|át rây
production|pờ rô đắc sờn
pressing|pờ rét sinh
adv|ây đi vi
avdeevka|áp đíp ca
utah| ta
akhtubinsk|ác tu binh
bryson|bờ rai sơn
sports|sờ pót
porto|pót tô
oac|oác
benavidez|bê na vi đét
vpf|vi pi ép
stanisic|sờ ta ni xích
kerem|kê rem
public|pắp bờ lích
rada|ra đa
normandy|no mát đi
gurpreet|gơ pờ rít
af|ây ép
boeing|bô inh
xttn|xét tuyển tài năng
teerasak|ti ra sắc
yoon|dun
tapper|táp pơ
wings|guynh
kramaric|cờ ra ma rích
rheinenergiestadion|rây ne nơ di sờ tây đờn
arsenal|át sê nan
hans|han sờ
verbena|vơ bê na
pimapa|pi ma pa
callum|ca lum
uka|u ca
stones|sờ tôn
fabio|pha bi ô
lank|lanh
williams|uy li am
grab|gờ ráp
hch|hát xê hát
gokhan|gô khan
ankara|an ca ra
trafford|cham phót
xhaka|xa ca
allianz|a li an dờ
toxic|tô xích
urozhaine|iu rô dai nê
suarez|sua a rét
gobus|gô bớt
whoscored|hu sờ co
grushko|gờ rút cô
coahuila|coa hui la
bash|bát sờ
delaunay|đê lau nây
azerbaijan|a déc bai dan
sandi|san đi
dios|đi ốt
bastad|bát tát
open|âu pần
slm|ét eo em
smart|sờ mác
tykhe|ti khê
ludwig|lúc vích
dublin|đu bờ lin
terzic|tơ dích
marathon|ma ra tông
barella|ba rê la
mittelstadt|mét teo sờ tát
achilles|a sin
toni|tô ni
ohio|ô hai ô
bezuidenhout|bê dui đên hâu
dumfries|đăm phờ ri
fifa|phi pha
rt|a ti
arab|a ráp
essex|ét sếch
pga|pi di ây
sharov|sa rốp
bs|bác sĩ
midnight|mít nai
wla|đắp liu eo ây
pleiku|pờ lây ku
ob|óp
maariv|ma ríp
myanmar|mi an ma
golden|gâu đần
newcastle|niu két xô
veltins|ven tin
hoxha|hốc ha
onerepublic|oăn ri pắp lích
hochiminh|hồ chí minh
amaland|a ma len
theerathon|thi ra thon
myeleanor|mi e lê a no
iii|i i i
marseille|mác xây
gowan|gô oan
vse|vi ét i
kobykov|cô bi cốp
maradona|ma ra đô na
goal|gôn
mlrs|em eo a ét
peissel|pây sen
class|cờ lát
bar|ba
par|pa
vs|vi ét
thaad|thát
wolves|guốp
pickford|pích phót
redfield|rét phiu
sucic|su xích
jason|dây sơn
barem|ba rem
ratcliffe|rát cờ líp
gruzia|gwof ru di a
zagoruykovka|da gô ruy cốp ca
village|vi lít
kan|can
dalic|đa lích
ardon|a đon
chaided|chết đựt
etten|ết tanh
menendez|mê nen đét
siupianocompetition|siu pi a nô com pe ti sờn
nancy|an xi
barnardo|bác nan đô
fbi|ép bi ai
as|ây ét
lhq|liên hợp quốc
shaw|so
calafiori|ca la phi ô ri
australian|ốt xờ trây li ần
murat|mu rát
sahin|sa hin
singapore|sinh ga po
flc|ép lờ xê
utd|iu nai tựt
altay|an tây
buffon|búp phông
al-hol|an hâu
kosovo|cô sô vô
zl|dét eo
wirz|vớt
mark|mác
depot|đi pót
fandi|phan đi
motor|mô tô
toulouse|tu lu
al-fashir|an pha xi
power|pao ờ
wall|gua
mithiang|mi thiêng
safiq|sa phích
iduna|i đu na
herzegovina|héc dơ gô vi a
iwamasa|i goa ma sa
shahriffuddin|sa ríp phút đin
traffic|tre phích
louis|lu ít
glen|gờ len
tunisia|tu ni di
hysaj|hai sác
guardiola|goát đi ô la
liz|lít
rafael|ra pha en
research|ri sớt
ternovaya|téc nô va da
hamburg|ham bớc
independent|in đi pen đần
cologne|cô lốc nhơ
mateu|mát têu
ngeow|ngoeo
szalai|sờ da lai
eic|i ai xi
yar|da
kishida|ki xi đa
seleccao|sê lê cao
fernandez|phét nan đét
paredes|pa re đét
and|en
tae|ta e
online|on lai
m|em
francesco|phờ ran xét cô
ap|ây pi
mannschaft|man sờ cháp
nathan|na than
fermin|phơ min
abyei|a bây
performed|pơ phom
busan|bu san
maria|ma ri a
navy|nây vi
berestovoye|bơ rét to vâu
rb|a bi
al-sultan|an su tan
rubio|ru bi ô
amino|a mi nô
sebastien|sê bát ti en
patrik|pa trích
pew|piu
leckie|lếch ki
edis|ê đít
vat|vát
frattesi|phờ rát tê si
cot|cốt
santis|san tít
esol|ê sôn
al-hasan|an ha san
belbek|beo bếch
piano|pi a nô
icon|i cừn
tbn|tây ban nha
adams|a đam
r|a
deloitte|đề lót
biden-trump|bi đen trăm
topdev|tóp dép
ndoye|en đoi
account|ơ cao
hot|hót
thaco|tha cô
royal|roi ồ
dpa|đi pi ây
dick|đích
tx|thị xã
sigonella|sích gô nê la
roosevelt|rút sơ veo
gdp|di đi pi
wechat|guy chát
antti|an ti
shadi_qh|xa đích
ariffin|a ríp phin
v-league|vi lích
scholarships|sờ co lờ síp
rigier|ri gi ơ
sevastopol|sê vát tô pon
vus|vê iu ét
his|hít
xavi|xa vi
feet|phít
switchblade|sờ uýt bờ lết
workshop|guốc xóp
yemen|i ê men
rennes|ren
wadein|oan đên
programs|pờ rô gờ rem
gmt|di em ti
look|lúc
skynews|sờ cai niu
antalyaspor|an ta lia sờ po
dortmund|đót mun
hadwin|hát uyn
hagari|ha ga ri
sang-sik|sang xích
wags|goách
leagues|lích
competition|com pe tin sừn
southcom|sao com
oyarzabal|o ri a da ban
saot|sao tờ
upamecano|u pa mê can nô
regconition|réc co ni sờn
thohir|tho hia
dave|đây
biden|bai đần
bike|bai cờ
v|vi
intercontinental|in tơ con ti nen xồ
acca|ác ca
http|ết ti ti pi
garcia|ga ci a
carbon|các bon
verba|vơ ba
berjaya|béc da gia
buergenstock|bơ ghên sờ tốc
sicily|si xi li
certificate|xơ ti phi kết
suphan|su phan
akanji|a can di
email|i mêu
piee|pai
heidi|hây đi
leopard|lê ô pát
ctcp|công ty cổ phần
saleh|sa lê
sutalo|su ta lô
country|can tri
fpv|ép pê vê
exchange|ích trên
blogger|bờ lóc gơ
kurakhove|ku ra khốp
neil|nê in
hotboy|hót boi
francisco|phờ ran xít cô
monza|môn da
ayatollah|a da tô la
andrey|an đờ rây
katanec|ca ta nếch
rubin|ru bin
kui|cui
autograph|au to gờ ráp
championship|chem pi ờn xíp
belgorod|beo gô rót
ali|a li
brozovic|bờ rô dô vích
iphone|ai phôn
struick|sờ truých
bruyne|bờ roai nơ
dominik|đô mi ních
memorial|me mô ri ờ
horsman|ho man
super|súp pơ
pavlovic|páp lô vích
arts|át
vlahovic|vờ la hô vích
watch|goát
atalanta|át ta lan ta
lisandro|li san đờ rô
mall|mô
liv|líp
trump|trăm
kirkegaard|kơ ke gát
juventus|du ven tút
mujtaba|mu ta ba
mahidol|ma hi đon
kampala|cam pa la
faa|ép ây ây
fc|ép xi
gambarashvili|gam ba rát vi li
signal|xích nồ
abdullah|áp đu la
illinois|i li noi
shakhtar|sác ta
phala|pha la
tokyo|tô ki ô
bogota|bô gô ta
knock-out|nốc ao
nih|ni
xander|san đơ
missouri|mít so ri
hochstein|hốc sờ tanh
ancelotti|an chê lốt ti
yamal|da man
magno|mác nô
junior|du ni ờ
emmanuel|em ma nu en
hyper|hai pơ
roberto|rô bét tô
marine|mơ rin
defodi|đề phâu đi
igor|i go
azovstal|a dốp tan
oda|ô đa
southgate|sao ghết
livestream|lai sờ trim
cybertruck|xai bơ trắc
mls|em eo ét
saic|sa ích
piotrowski|pai âu trốp sờ ki
las|lát
kawasaki|ca goa sa ki
sergei|xéc giây
djimsiti|đờ dim si ti
bet|bét
scalvini|sờ can vi ni
roe|râu
fuente|phu en tê
gvozdika|gờ vốt đi ca
freeppik|phờ ri pích
ftu|ép tê u
almeida|an mây đa
ruud|rút
optimization|óp ti mai dây sừn
novovodyanoye|nô vô vô dia noi
khmelnitsky|khơ mên nít sờ ki
ediin|ê đin
ukulele|u ku lê lê
mainoo|mai nu
act|ách
laura|lau ra
billstrom|biu sờ trom
kritsada|cờ rít sa đa
opta|óp ta
sommermarchen|so mơ ma ních
abu|a bu
supachai|su pa chai
yuka|du ca
copa|cốp pa
yo|du ô
quarta|qua ta
haiprakhon|ha íp pờ ra khôn
woods|út
mijak|mi giắc
sinai|si nai
uranium|u ra ni um
jung|giăng
saka|sa ca
youssef|giâu sép
selecao|sê lê cao
yaga|da ga
dechambeau|đề cham bâu
beckenbauer|bếch ken bau ơ
khor|kho
vpbank|vi pi banh
official|óp phít xồ
journal|do nồ
venezuela|vê nê duê la
wikimedia|uy ki mê đi a
next|nếch
becker|bếch cơ
eeas|i i ây ét
roberta|rô bớt ta
phenikaa|phe ni ca
robot|rô bốt
heli|hê li
kfarkela|cờ pha kê la
methaphetamine|mê tha phê ta min
jennifer|den ni phơ
half|háp
poseidon|pô sây đông
aviv|a víp
kauai|ca uây
pukhraj|púc ra
kinzhal|kin dờ han
mayol|ma don
helena|hê lê na
entrepreneurs|en tơ pờ rơ nêu
sergey|séc giây
sctv|ét xi ti vi
pssi|pi ét ét ai
coman|cô man
clb|câu lạc bộ
palmieri|pan mê ri
mail|mêu
manara|ma na ra
champinship|chem pi ần xíp
jerome|dê rôm
walker|oắc cơ
currywurst|cơ ri út
tadic|ta đích
barnabas|ba na bát
michal|mi can
charles|chác li
johnny|don ni
kyle|cai
vava|va va
goes|gâu sờ
perisic|pê ri xích
torbjorn|to bi don
marca|mác ca
skriniar|sờ ki nia
henry|hen ri
kiel|ki eo
ct|ci ti
dnepr|đi en i pi a
kai|cai
shamil|sa miu
mentor|men tờ
kt|kinh tế
tmcp|thương mại cổ phần
atamcs|a ta xê mwof ét
brodin|bờ rô đin
rishi|ri xi
marius|ma ri ớt
glock|gờ lóc
bloomberg|bờ lum bớc
alto|an tô
planetlabs|pờ lan nét láp
herald|hê rát
ghtk|giao hàng tiết kiệm
granite|gờ ra nít
juba|du ba
luxembourg|lúc xem bua
putra|pu tra
zverev|dờ ve rép
munich|mu ních
olivier|ô li vi ê
sejong|sê dong
margaret|ma ga rét
eagle|i gồ
hotline|hót lai
green|gờ rin
krzysztof|cờ ri sờ tóp
nga-ukraine|nga u cờ rai na
younis|dô nít
true|tru
rmit|rờ mít
steve|sờ típ
krasnodar|cơ rát nô đa
southwest|sao goét
minigame|mi ni gêm
clarence|cờ le rần
brentford|bờ ren phót
henri|hen ri
gps|di pi ét
sinwar|sin gua
sturm|sờ tơm
lee|li
global|gờ lâu bồ
jaha|da ha
geovane|dê ô vơ ni
hungary|hung ga ri
uruguay|u ru guay
cuba|cu ba
kostic|cót tích
hawk|hoắc
declan|đéc cờ lan
hiroshima|hi rô xi ma
ajeti|a dê ti
sophia|sô phi a
gerardo|dê rát đô
who|hu
tribune|tri bi un
davide|đa vi đê
bellingham|be linh ham
macedonia|mác xê đô ni a
marder|ma đờ
sbs|ét bi ét
luiz|lu ít
dong-a|đông á
ios|ai âu ét
unisfa|u ni sờ pha
asset|át sét
ktur|cờ tơ
shopee|xóp pi
aff|ây ép ép
metro|mê trô
kyiv|ki ép
hakkanen|hác can nên
marlon|ma lon
leroy|lê roi
